111111111111
100000P00001
100001100000
10000E000011
111111111111
