111111111111111111
100001000000001001
101001100101001001
1010C100P101001001
10C0C100C1C1001001
1E0000000001000001
111111111111111111