11111111111111
1C00P00C000001
11111111111101
10000000000001
10010011111101
101100000011C1
1E000000000001
11111111111111