1111111111
10101C1E01
1C10101001
100CP00001
1010011111
10100C00C1
1111111111