1111111110
1000000001
1C00P00C01
1000000001
1111111111