11111111111
100000010E1
10000P01001
10000001111
10000C00001
11111111111