1111111111111
1C000C000C001
1000100010001
1001010101001
1C100010001C1
1010000000101
1C01000001001
1000100010C01
1000010100001
10C0C010C0001
10E000000CP01
1111111111111