1111111111111111111111111111111111111111
1000000000000000000000000000000000000001
1000000000000000000000000000000000000001
1000000000000000000000000000000000000001
100000000000C00000000000000C000000000001
1000000000000000000000000000000000000001
1000000000001111111111111100000000000001
1000000000000000C00000000000000000000001
1000000000000000000000000000C00000000001
1000000000000000000000000000000000000001
100000000000000000000E000000000000000001
1000000000000000000000000000000000000001
1000000000000000000000000000000000000001
1000000000000000000000000000C00000000001
10C0000000001111111111111100000000000001
10C0000000000000000000000000000000000001
1000000000000000000000000000000000000001
1000000C00000000000000000000000000000001
1000000000000000000000000000C00000000001
1000000000000000000000000000000000000001
1P0000000000000000C000000000000000000001
1111111111111111111111111111111111111111