111111111
110000001
1E000C101
111P00001
111111111
