1111111111111
10000C0000011
1E00001000011
11100P0000011
1000C00000011
1000000000011
1111111111111
